#######
#s    #
####  #
#     #
# #####
#    e#
#######
