###################
#s               t#
####              #
#        o        #
#             #####
#                 #
#e                #
#                 #
#                 #
#                 #
#                 #
#                 #
#                 #
#                 #
#                 #
#                 #
#                 #
#                 #
#                 #
###################
