#########################
#                 #     #
#                 #     #
#####             #    e#
#                       #
#                       #
#        o#        #    #
#        #####    #### ##
#                       #
#                       #
###########             #
#                       #
#                   t   #
#          #            #
#          #            #
#          ##############
#                       #
#                   s   #
##########################