###################
#s    #          t#
#     #           #
#     #  o        #
#          ########
#                 #
#e                #
#                 #
#                 #
#                 #
#                 #
#                 #
#                 #
#                 #
#                 #
#                 #
#                 #
#                 #
#                 #
###################
