########################################################################
#             #                       t                    #           #
#                                                          #           #
#                      ####   #####                        #          e#
#             #        #          #                                    #
#          ###################################                         #
#          #                                o#             #           #
#                                            #####        #######     ##
#                                            #                         #
#          #                                                           #
#          #                                                           #
############                                 #                         #
#          #                                 #                         #
#                                            #                         #
#                                            #                         #
#          #                                 #                         #
#          #                                 #                         #
#          ###################################                         #
#                            #                                         #
#                            #                                         #
#          #                 #               #                         #
#          #                                 #                         #
#          #                                 #                 s       #
########################################################################
