###################
#s  o #          t#
#     #     o     #
#     #  o        #
#          ########
#o       o        #
#e                #
#                 #
#                 #
#                 #
#                 #
#                 #
#                 #
#                 #
#                 #
#                 #
#                 #
#                 #
#                 #
###################
