###################
#s  o #           #
#     #       to  #
#     #  o        #
#          ########
#o    t  o        #
#e t              #
#                 #
#                 #
#                 #
#                 #
#                 #
#                 #
#                 #
#                 #
#                 #
#                 #
#                 #
#                 #
###################
